111111111111111111111111111111111111111111111111111111111111111111111111111111111111111
1E0000000000000C00000C00000000000100000000000000000000000000000000000000000000000000011
101001010010000010100100000001010110000000000000000000000000000000000000000000000000111
101001001010101000100100000001010110000000000000000000000010100000000000000000000000111
1P0000000C00C0000000000000000000C100000000000000000000000000000000000000000000000000111
111111111111111111111111111111111111111111111111111111111111111111111111111111111111111